Estos son los códigos que debes usar para cada país:

Alemania: DEU
Reino Unido: GBR
Estados Unidos: USA
Dinamarca: DNK
Francia: FRA
Italia: ITA
España: ESP
Suecia: SWE
Países Bajos: NLD
Austria: AUT
Brasil: BRA
Polonia: POL
México: MEX
Noruega: NOR
Finlandia: FIN
Suiza: CHE
China: CHN
Bélgica: BEL
Irlanda: IRL
Canadá: CAN
Australia: AUS
Japón: JPN
Rusia: RUS
Indonesia: IDN
Colombia: COL
Israel: ISR
Hong Kong: HKG
Argentina: ARG
India: IND
Tailandia: THA
Venezuela: VEN
Taiwán: TWN
Sudáfrica: ZAF
Ucrania: UKR
Costa Rica: CRI
Corea del Sur: KOR
Hungría: HUN
Portugal: PRT
Chile: CHL
Nueva Zelanda: NZL
República Checa: CZE
Filipinas: PHL
Estonia: EST
Turquía: TUR
Eslovenia: SVN
Perú: PER
Islandia: ISL
Luxemburgo: LUX
Rumania: ROU
Eslovaquia: SVK
Guatemala: GTM
Ecuador: ECU
Grecia: GRC
República Dominicana: DOM
Marruecos: MAR
Malasia: MYS
Lituania: LTU
Croacia: HRV
Puerto Rico: PRI
Singapur: SGP
Serbia: SRB
Kenia: KEN
Kazajistán: KAZ
Letonia: LVA
Panamá: PAN
Bielorrusia: BLR
Bulgaria: BGR
Etiopía: ETH
Uruguay: URY
Egipto: EGY
Chipre: CYP
Islas Feroe: FRO
Paraguay: PRY
Irán: IRN
Honduras: HND
Vietnam: VNM
Inglaterra: GBR
Bosnia y Herzegovina: BIH
Bolivia: BOL
El Salvador: SLV
Pakistán: PAK
Malta: MLT
Mongolia: MNG
Túnez: TUN
Macedonia del Norte: MKD
Nigeria: NGA
Armenia: ARM
Moldavia: MDA
Maldivas: MDV
Liechtenstein: LIE
Nicaragua: NIC
Líbano: LBN
Uganda: UGA
Macao: MAC
Zimbabue: ZWE
Jamaica: JAM
Cuba: CUB
Afganistán: AFG
Nepal: NPL
Tanzania: TZA
Andorra: AND
Esuatini: SWZ
Yibuti: DJI
Groenlandia: GRL
Guadalupe: GLP
Myanmar: MMR
Fiyi: FIJ
Libia: LBY
Santa Lucía: LCA
Emiratos Árabes Unidos: UAE
Kuwait: KWT
Palestina: PSE
Angola: AGO
Sri Lanka: LKA

Estos son los códigos para distintas regiones:

América Latina: ARG, BOL, BRA, CHL, COL, CRI, CUB, DOM, ECU, SLV, GTM, HND, MEX, NIC, PAN, PRY, PER, PRI, SLV, URY, VEN

Europa: ALB, AND, ARM, AUT, BEL, BIH, BGR, BLR, HRV, CYP, CZE, DNK, ENG, EST, FIN, FRA, FRO, GEO, DEU, GIB, GRC, NLD, HUN, IRL, ISL, ITA, JEY, KOS, LVA, LIE, LTU, LUX, MDA, MKD, MLT, MON, MNE, NLD, NIR, NOR, POL, PRT, ROU, RUS, SCO, SMR, SRB, CHE, SVK, SVN, SWE, TUR, UKR, WLS

América: ANT, ABW, BHS, BRB, BMU, BLZ, CAN, CYM, CRI, DOM, GLP, GUY, HND, HTI, JAM, MEX, MSR, NIC, PAN, PRY, PRI, SLV, SUR, TTO, USA, VCT, VGB

África: AGO, DZA, AGO, BEN, BFA, BWA, BFA, CAF, CMR, CIV, COM, COD, DJI, EGY, ERI, ETH, GMB, GHA, GIN, KEN, LBY, LBR, LSO, MDG, MAR, MWI, MLI, MOZ, NAM, NER, NGA, RWA, SDN, SEN, SLE, SOM, SWZ, TZA, TGO, TUN, UGA, ZAF, ZMB, ZWE

Asia: AFG, ARM, AZE, BGD, BTN, BRN, CHN, CYP, GEO, HKG, IDN, IND, IRN, IRQ, ISR, JPN, JOR, KAZ, KOR, KWT, LAO, LBN, MAC, MYS, MNG, MMR, NPL, OMN, PAK, PSE, QAT, SAU, SGP, LKA, SYR, TWN, TJK, TKM, TLS, THA, UAE, UZB, VNM, YEM

Sudamérica: ARG, BOL, BRA, CHL, COL, ECU, GUY, PRY, PER, SUR, URY, VEN
